.........................................
.........................................
....................P.......M.....M......
..........1111111111111111111111111111111
..........0000000000000000000000000000000
..........0000000000000000000000000000000
..........0000000000000000000000000000000
..........0000000000000000000000000000000
